1_ 1_ 1_ 1_ 1_ 1_ 1_ 1_ 1_ 1_ 1_ 1_ 1_ 1_
2_ 2_ 2_ 2_ 2_ 2_ 2_ 2_ 2_ 2_ 2_ 2_ 2_ 2_
3_ 3_ 3_ 3_ 3_ 3_ 3_ 3_ 3_ 3_ 3_ 3_ 3_ 3_
4_ 4_ 4_ 4_ 4_ 4_ 4_ 4_ 4_ 4_ 4_ 4_ 4_ 4_
5_ 5_ 5_ 5_ 5_ 5_ 5_ 5_ 5_ 5_ 5_ 5_ 5_ 5_
6_ 6_ 6_ 6_ 6_ 6_ 6_ 6_ 6_ 6_ 6_ 6_ 6_ 6_
7_ 7_ 7_ 7_ 7_ 7_ 7_ 7_ 7_ 7_ 7_ 7_ 7_ 7_
8_ 8_ 8_ 8_ 8_ 8_ 8_ 8_ 8_ 8_ 8_ 8_ 8_ 8_