1_ 1_ 0_ 0_ 0_ 0_ 1_ 1_ 1_ 1_ 1_ 1_ 1_ 1_ 1_ 1_
1_ 0_ 0_ 0_ 0_ 1_ 1_ 0_ 0_ 1_ 1_ 0_ 0_ 1_ 1_ 1_
1_ 0_ 0_ 0_ 0_ 0_ 0_ 1_ 0_ 1_ 0_ 0_ 1_ 1_ 1_ 1_
0_ 0_ 0_ 0_ 0_ 0_ 0_ 1_ 0_ 0_ 0_ 1_ 1_ 0_ 1_ 0_
1_ 0_ 1_ 0_ 0_ 1_ 0_ 1_ 0_ 0_ 0_ 1_ 1_ 0_ 0_ 0_
0_ 0_ 1_ 1_ 1_ 0_ 1_ 1_ 0_ 1_ 1_ 0_ 0_ 0_ 0_ 1_
1_ 1_ 1_ 1_ 0_ 0_ 1_ 1_ 1_ 1_ 1_ 1_ 1_ 1_ 0_ 0_
1_ 1_ 1_ 1_ 0_ 0_ 0_ 0_ 1_ 1_ 1_ 0_ 0_ 0_ 1_ 1_
1_ 0_ 1_ 1_ 1_ 1_ 1_ 1_ 0_ 0_ 1_ 0_ 0_ 1_ 1_ 1_
1_ 1_ 0_ 0_ 0_ 1_ 0_ 1_ 0_ 0_ 1_ 1_ 1_ 0_ 0_ 1_
1_ 1_ 1_ 1_ 1_ 1_ 1_ 1_ 1_ 1_ 0_ 0_ 0_ 0_ 0_ 0_