7_ 7R 9_ 1_ 8_ 3G 9_ 4_ 6S 7_ 2_ 5_ 2S 8_ 6P 4_
4_ 8_ 9_ 2_ 8_ 2_ 4P 7_ 5_ 9D 7_ 3P 6_ 5_ 7_ 7G
0_ 1_ 7P 0_ 8_ 3_ 6_ 5L 5_ 0_ 7_ 0_ 6_ 2_ 6_ 6_
9R 3_ 8_ 5_ 3_ 6_ 4G 1_ 1S 4_ 5_ 6S 2_ 9_ 0_ 0_
8_ 8_ 7L 4_ 9_ 2_ 1_ 9_ 4_ 6_ 3D 3_ 5D 5_ 7_ 4S
1D 1_ 1_ 2_ 6_ 2_ 2R 2_ 0_ 2_ 8_ 2L 2_ 2P 3_ 8_
9_ 5_ 7D 4_ 3P 0_ 3_ 4_ 1_ 8_ 3_ 5_ 1S 9_ 4_ 4_
3_ 5S 0_ 3_ 5_ 7_ 1_ 4_ 1_ 8_ 2_ 9_ 4_ 7_ 0_ 2G
6D 8_ 1G 0_ 9_ 9P 3_ 2_ 9_ 5G 8_ 8_ 2_ 0_ 4_ 2_
6_ 5_ 8_ 0_ 4_ 3_ 3_ 0_ 5S 1_ 8_ 1_ 4S 5_ 9_ 5L
4D 3_ 9_ 9P 2_ 5_ 4_ 8D 4_ 2G 7_ 2_ 8_ 0_ 4G 7_