9_ 9_ 9_ 1_ 7_ 7_ 1_ 7_ 7_ 1_ 9_ 9_ 9_
9_ 1_ 1_ 7_ 7_ 7_ 7_ 7_ 7_ 7_ 1_ 1_ 9_
9_ 1_ 7_ 7_ 7_ 7_ 7D 7_ 7_ 7_ 7_ 1_ 9_
1_ 7_ 7_ 7_ 7R 7_ 7D 7_ 7R 7_ 7_ 7_ 1_
1_ 7_ 7_ 7_ 7R 7_ 7D 7_ 7R 7_ 7_ 7_ 1_
1_ 7_ 7_ 7_ 7_ 7_ 7D 7_ 7_ 7_ 7_ 7_ 1_
1_ 1_ 7_ 7_ 7_ 7_ 7_ 7_ 7_ 7_ 7_ 1_ 1_
1_ 1_ 1_ 7_ 7P 7_ 7_ 7_ 7P 7_ 1_ 1_ 1_
1_ 1_ 1_ 1_ 7_ 7_ 7P 7_ 7_ 1_ 1_ 1_ 1_
9_ 1_ 1_ 1_ 1_ 7_ 7_ 7_ 1_ 1_ 1_ 1_ 9_
9_ 1_ 1_ 1_ 1_ 1_ 7_ 1_ 1_ 1_ 1_ 1_ 9_
9_ 9_ 9_ 1_ 1_ 1_ 1_ 1_ 1_ 1_ 9_ 9_ 9_
